# ###########################################################
#      # #                   #         #   #     # #   # #   #
# # # # # # # # # ### # ####### # ##### ### # # # ### # ### #
# # # #   # # # #   # # #     # #       #   # #   # #       #
### ### ##### ##### ##### ##### # ######### # # ### # ### # #
# #       #   # #     #         #           # # # # #   # # #
# # ##### ### # # ####### # ### # ########### ### # ### ### #
# #   #     # #   #     # # # # #       # #         #   # # #
# ##### # ##### ### ### # ### # ### ##### ### ####### ### ###
#       # #   #   #   # # #   # #     # #     # #   #   #   #
# ######### ### ### ####### # ######### ### ### # ### # # ###
# # #     #   #     #   #   #       #   #     #   #   #   # #
### # ####### # ### ### # ####### # ### # ### # # # # # # # #
#   # #         #       #     # # #   #   # # # #   # # #   #
# ### # ####### ######### ### # ### ### ### # ########### # #
#       #   #     #     #   #   #       #     # #     #   # #
### # # ### ### ##### ### ################# # # # # ##### # #
#   # #   #           # #   #             # #     #   #   # #
##### # ##### ##### # # ##### ##### ####### ### ##### # #####
#     #     # # #   # # # #     #         # #     # #       #
# ### ####### # # ##### # ### ### ####### # # ##### # # ### #
# #   # # # # #     #       # # # #         #   #     #   # #
# ### # # # ####### # # ### # # # # ############### # # ### #
#   #             # # #   # # #   #   #   # #   # # # # #   #
# ### # # # ######### ### # # ### # ### ### # # # ### #######
#   # # # #     #       # # # # # #   #     # # #   #   #   #
# ### ######### # ####### ##### ##### # ####### ### ##### ###
#   #       #       # #               #               # # # #
### # # # ##### # ### ### # ### # # ### # ### ######### # # #
#   # # #   #   # # #   # # #   # #   # #   # #       #     #
##### ######### # # ### # ######### # ### ### ### ##### # ###
#       # #     # #       #   #   # # #     #       #   # # #
# ### ### ##### ##### ### ### ### ### # ### ####### # ### # #
# # #   #     #   #   #   #   #           # #   #   #   #   #
### # ##### # # ########### ##### # ### # ### ##### # # ### #
#   #     # #         # #         #   # # #   #       # #   #
# # # # ####### ####### ### ### ########### ### # # # ##### #
# # # #     #         #   #   # #   # #     #   # # #     # #
### # # ######### ####### # ### ### # # # # ### ### # ### ###
#     #         #         # #           # # #   #   #   #   
########################################################### 
